name,email,insertions,deletions,lines_changed,files,commits,first_commit,last_commit
Thierry OnkelinxThierry onkelinxThierryO,thierry.onkelinx@inbo.be,18088,7464,25552,1382,370,2018-09-06 14:50:17+00:00,2024-09-06 09:45:20+00:00
LOMMELENElsLommelen,els.lommelen@inbo.be,132,70,202,34,28,2019-04-25 15:41:14+00:00,2019-09-18 09:26:39+00:00
florisvdh,floris.vanderhaeghe@inbo.be,157,84,241,39,24,2018-10-26 19:09:45+00:00,2020-09-23 12:08:43+00:00
Hans Van Calster,hans.vancalster@inbo.be,34,34,68,5,5,2019-02-28 07:19:45+00:00,2019-02-28 08:31:58+00:00
Katrin Leinweber,kalei@posteo.de,17,17,34,6,2,2019-06-07 08:15:56+00:00,2019-06-07 08:16:33+00:00
MaÃ«lle Salmon,maelle.salmon@yahoo.se,31,33,64,2,2,2019-06-19 07:54:24+00:00,2024-07-17 16:02:50+00:00
Peter Desmet,peter.desmet@inbo.be,2,2,4,2,2,2019-09-27 11:38:34+00:00,2019-09-27 11:40:44+00:00
Katrin Leinweber,9948149+katrinleinweber@users.noreply.github.com,2,2,4,1,1,2019-06-07 08:03:03+00:00,2019-06-07 08:03:03+00:00
Peter Desmet,peter.desmet.work@gmail.com,0,0,0,0,1,2019-06-04 09:39:52+00:00,2019-06-04 09:39:52+00:00
Stefan Widgren,stefan.widgren@gmail.com,2,1,3,1,1,2022-02-23 18:47:37+00:00,2022-02-23 18:47:37+00:00
Thierry Onkelinx,thierryo@users.noreply.github.com,1,1,2,1,1,2018-12-04 08:57:11+00:00,2018-12-04 08:57:11+00:00
